00000100000000010000000000000000
00000100000000100000000000000000
00000100000001010000000000000101
00000100000010000000000000101000
00001100001000110000000000000000
00000100000000000000000000000000
01000000011001010010000000000101
00000100000000000000000000000001
00000100000000000000000000000000
00010100100000000000000000001000
00010000010000110000000000101000
00000100010000100000000000000100
00000100001000010000000000000100
00000100000000000000000000000000
01000000001010000011000000000100
00000100000000000000000000000001
00000100000000000000000000000000
00011000110000001111111111001000
