00000100000000000000000000000001
00000100000000000000000000000010
00000100000000000000000000000011
00000100000000000000000000000100
00000100000000000000000000000101
00000100000000000000000000000110
00000100000000000000000000000111
00000100000000000000000000001000
